7,7,0,0,0,0,0,0,0,0,0,0,0,0,0,0,0,0,0,0,0,0,0,0,0,0,0,0,0,0,0,0,0,0,0,0,0,0,0,0,0,0,0,0,0,0,0,0,0,0,
8,8,0,0,0,0,0,0,0,0,0,0,0,0,0,0,0,0,0,0,0,0,0,0,0,0,0,0,0,0,0,0,0,0,0,0,0,0,0,0,0,0,0,0,0,0,0,0,0,0,
8,8,0,0,0,0,0,0,0,0,0,0,0,0,0,0,0,0,0,0,0,0,0,0,0,0,0,0,0,0,0,0,0,0,0,0,0,0,0,0,0,0,0,0,0,0,0,0,0,0,
8,8,7,0,0,0,0,0,0,0,7,0,9,0,0,0,0,0,0,0,0,0,0,0,0,0,0,0,0,0,0,0,0,0,0,0,0,0,0,0,0,0,0,0,0,0,0,0,0,0,
8,8,8,0,0,0,0,0,0,0,8,0,0,0,0,0,0,0,0,0,0,0,0,0,0,0,0,0,0,0,0,0,0,0,0,7,0,0,0,0,0,0,0,0,0,0,0,0,0,0,
8,8,8,0,0,0,0,0,0,7,8,0,0,0,0,0,0,0,0,0,0,0,0,0,0,0,0,0,0,0,0,0,0,7,0,8,0,0,0,0,0,0,0,0,0,0,0,0,0,0,
8,8,8,0,0,0,0,0,0,8,8,0,0,0,0,0,0,0,0,0,0,0,0,0,0,0,0,0,0,0,0,7,0,8,0,8,0,0,0,0,0,0,0,0,0,0,0,0,0,0,
8,8,8,0,0,0,0,0,7,8,8,0,0,0,0,0,0,0,0,0,0,0,0,0,0,0,0,7,0,7,0,8,0,8,0,8,0,0,0,0,0,0,0,0,0,0,0,0,0,0,
8,8,8,0,0,0,0,7,8,8,8,0,0,0,0,0,0,0,0,0,0,0,0,0,0,0,7,8,0,8,0,8,0,8,0,8,0,0,0,0,0,0,0,0,0,0,0,0,0,0,
8,8,8,0,0,0,0,8,8,8,8,0,0,0,0,0,2,0,0,0,0,0,0,0,0,0,8,8,0,8,0,8,0,8,0,8,0,0,0,0,0,0,0,0,0,0,0,0,0,0,
8,8,8,7,7,7,7,7,7,7,7,0,0,0,0,0,1,0,0,0,0,0,0,7,7,7,8,8,0,8,0,8,0,8,0,8,0,0,0,7,7,7,7,7,7,7,7,7,7,7,
